1953,1953,1953,1953,1953,1953,1953,1953,1953,8657,8658,1953,1953,1953,1953,
1953,9657,9658,9456,9457,1953,1953,1953,269,8757,8758,1953,1953,1953,1953,
1953,9757,9758,9556,9557,1953,1953,1953,369,1953,1953,1953,1953,9552,1953,
1953,1953,1953,1953,1953,1953,1953,1953,1953,1953,1953,1953,9154,9155,1953,
1953,1953,1953,1953,4654,4655,4655,4655,4655,4655,4656,1953,9254,9255,1953,
1953,1953,1953,1953,4754,4755,4965,4966,4967,4755,4756,1953,9354,9355,1953,
1953,1953,1953,1953,4754,4755,5065,5066,5067,4755,4756,1953,9454,9455,1953,
1953,1953,1953,1953,4854,4855,4855,4855,4855,4855,4856,1953,1953,9555,1953,
1953,1953,1953,1953,1953,1953,1953,1953,1953,1953,1953,1953,1953,1953,1953,
1953,1953,1953,1953,1953,1953,1953,1953,1953,1953,1953,1953,1953,1953,1953,
1953,1953,1953,1953,1953,1953,1953,1953,1953,1953,1953,1953,1953,1953,1953,
1953,1953,1953,1953,1953,1953,1953,1953,1953,1953,1953,1953,1953,1953,1953,
1953,1953,1953,1953,1953,1953,1953,1953,1953,1953,1953,1953,1953,1953,1953,
1953,1953,1953,1953,1953,1953,1953,1953,1953,1953,1953,1953,1953,1953,1953,
1953,1953,1953,1953,1953,1953,1953,1953,1953,1953,1953,1953,1953,1953,1953,
